1111111111111111
1P10000000000001
1010111110000001
1010100100111111
1000100100100001
1110100000000001
1000000000000001
1001111110111111
1001000000000001
1001111111111111
1010C00000000001
1010000000000001
1001100000011111
10C0000E00000001
100C0000010000E1
1111111111111111