1111111111111111
1P00000000000001
10000000000C0001
10000C0000000001
100000000000C001
1000C00000000001
1000000000000001
1000000000000001
10000C0000C00001
1000000000000001
1000000000000001
1000000000000001
10000C0000000001
100000000000C001
10000000000000E1
1111111111111111