1111111111111111111
100C0000010000000P1
1011011001001101101
1011010111110101101
1000010001000100001
1000011100011100001
100001000E000100001
1000010110110100001
1000000000000000001
1011011001111000001
1C01000001110000C01
1000000000100000001
1011011001111000001
1111111111111111111