1111111111111111111
1P10001111110000101
10100C01111000001C1
10111000110000C1101
1010000001000111101
1010C00000000000001
10111111001111111C1
1000000001000000001
1011111111011111101
1011110C1110E000101
10000001111100000M1
1111111111111111111