1111111111111111111
1P0C000001000000001
10110110010011011C1
1011010111110101101
1000010001000100001
10000111000111000C1
100001000E000100001
1000010110110100001
1000000000000000001
1011011001111000001
1C01000001110000C01
1000000000100000001
10110110011110000M1
1111111111111111111